#____________________________________________#
#____________________________________________#
#____________________________________________#
#____________________________________________#
#____________________________________________#
#____________________________________________#
#____________________________________________#
#__________k_________________________________#
#_______#######______________________________#
#____________________________________________#
#_____________________#______________________#
#____________________________________________#
#___#__________________________#_____________#
#____________________________________________#
#____________________________________________#
#__________________#_________________________#
#_____________________________________#______#
#____________________________________________#
#____________________________________________#
#########__##__##########______###############
#########__##__##########______###############
#______#_____________________________________#
#___________________#_________________#______#
#____________________________________________#
#______#_______________________#_____________#
#____________#_______________________________#
#________________________#___________________#
#____________________________________________#
#_____________#______________________________#
#______##_____________________________########
#____________________________________________#
#_________#__________________________________#
#____________________________________________#
#______________________######________________#
#____________________________________________#
#______________#####_______________#_________#
#____________________________________________#
#_______#####______________#_________________#
#____________________________________________#
#####_____#######__________####____###########
#####_____#######__________####____###########
#__________#_________________________________#
#____________________#_______________________#
#___________________________#________________#
#_______________________#____________________#
#________#######_____________________________#
#_________#######_______________###__________#
#__________#####_____________________________#
#____________###_____________________________#
#____________________________________________#
#___________________###########_________#____#
#_____________________#######________________#
#________________________#___________________#
#___________#________________________________#
#_________#####______________________________#
#_______#########____________________##______#
##__________________________________________##
###________________________________________###
####______________________________________####
#####____________________________________#####
#______________________________##____________#
#____________________________________________#
#__#####_____________________________________#
#_____________________#####__________________#
#___________#_____________________________####
#____________________________________________#
#____#_______________________________________#
#____________________________________________#
#___________##____________________#######____#
#____________________________________________#
#_________________#________#_________________#
#####_____________#__________________________#
#_______________________________________#____#
#____________________________________________#
#_______#______#_____________________________#
#_______#______#_________________##__________#
#_______#______#___#_________________________#
#__________________#_________________________#
#____#_______________________#_______________#
######__________________________________######
#####__________________________________#_#####
####_______#____________##________________####
###________________________________________###
##__________________________________________##
#____###__________________________________####
#_____________________########_______________#
#_____________________________________#______#
#____________________________________________#
#___________#####____________________________#
#________________________________###_________#
#____________________________________________#
#####________________________________________#
#________________###_________________________#
#____________________________________________#
#____###_______________________######________#
#__________________#_________________________#
#__________p_________________________________#
#_____###########______________#_____________#
#_____#_________#____________________________#
##############################################