#____________________________________________#
#____________________________________________#
#____________________________________________#
#____________________________________________#
#__________________#_________________________#
#__________________#_________________________#
#__________________#_________________________#
#__________k_______#_________________________#
#_______#######____#_________________________#
#__________________#_________________________#
#__________________#__#______________________#
#__________________#_________________________#
#___#______________#___________#_____________#
#___#______________#___________#_____________#
#__________________#_________________________#
#__________________#_________________________#
#__________##_________________________#______#
#____________________________________________#
#____________________________________________#
########___##__##########______####____#######
########___##__##########______####____#######
#______#_____________________________________#
#______#____________#_________________#______#
#_____________________________________#______#
#______#_______________________#_____________#
#______#_____#_______________________________#
#____________##__________#___________________#
#________________________#___________________#
#_____________#______________________________#
#______##_____________________________########
#__________________#_________________________#
#_________#__________________________________#
#_________________________________###________#
#______________________######________________#
#____________________________________________#
#______________#####_______________#_________#
#_________#######____________________________#
#_______#####______________#_________________#
#____________________________________________#
#####_____#######__________####____###########
#####_____#######__________####____###########
#__________#_________________________________#
#____________________#_______________________#
#___________________________#________________#
#_______________________#____________________#
#________#######_____________________________#
#_________#######_______________###__________#
#__________#####_____________________________#
#____________###_____________________________#
#____________________________________________#
#___________________###########_________#____#
#_____________________#######________________#
#________________________#___________________#
#___________#________________________________#
#_________#####______________________________#
#_______#########____________________##______#
##_______#######____________________________##
###_______#####____________________________###
####_______###____________________________####
#####_______#___________________#________#####
######_________________________##____________#
#######______________________________________#
########____________________________________##
#_____________________#####________________###
#___________##____________________________####
#____________________________________________#
#____##______________________________________#
#___________##_______________________________#
#___________##____________________#######____#
#_________________________________#######____#
#_________________#________#_________________#
#####_____________#________#_________________#
#__________________________#____________#____#
#_______#_______________________________#____#
#_______#______#_____________________________#
#_______#______#___#_____________##__________#
#_______#______#___#_________________________#
#__________________#_________#_______________#
#____#_______________________#_______________#
######__________________________________######
#####__________________________________#_#####
####_______#____________##________________####
###________________________________________###
##______________#___________________________##
#____###________________#######______________#
#_____________________########_______________#
#_____________________________________#______#
#___________#________________________________#
#___________##__________________###__________#
#________________________________###_________#
#________________#___________________________#
##_______________##__________________________#
###______________###_____________######______#
####______________##____________######_______#
#####______________#___________######________#
######_______________________________________#
#######______________________________________#
########_____________________________________#
#########p___________________________________#
##############################################