#______________________#
#______________________#
#______________________#
#__________k___________#
#________####__________#
#______________________#
#______________________#
#__#___________________#
#______________________#
#______________________#
#________________#_____#
#______________________#
#_____#________________#
#______________________#
#______________________#
#______________________#
#______________________#
#_______#####__________#
#__________________#___#
#______________________#
#______________________#
#___#__________________#
#___________________####
#______________________#
#______#_______________#
#______________________#
#___________#####______#
#______________________#
#______________________#
#####__________________#
#______________________#
#______________________#
#_______#______#_______#
#_______#__p___#_______#
#_______########_______#
#______________________#
#________#_____________#
#____#__###___#________#
#____#________#________#
########################